S	./sources_bonus/images/hey.xpm	
N	./sources_bonus/images/hey.xpm	
E	./sources_bonus/images/hey.xpm
W	./sources_bonus/images/hey.xpm

F                                           57,125,67
C      102,129,1

   111111111
  10000000N01
  11111111111111