S	./sources_bonus/images/S.xpm	
N	./sources_bonus/images/N.xpm	
E	./sources_bonus/images/E.xpm
W	./sources_bonus/images/W.xpm

F 57,102,65
C      102,129,244

1111111111111111111111111
 1000E00000110000000000001
1011000001110000000000001
1001000000000000000000001
11111111101100000111000111111111111111
11110111111111011100000010001
11110111111111011101010010001
11000000110101011100000010001
10000000000000001100000010001
10000000000000001101010010001
110000011101010111110111100111
11110111 1110101 101111010001
11111111 1111111 111111111111
1111111111111111111111111

