S	./sources/images/S.xpm	
N	./sources/images/N.xpm	
E	./sources/images/E.xpm
W	./sources/images/W.xpm

F 57,94,37
C 86,116,249

1111111111111111111111111
 1000E00000110000000000001
1011000001110000000000001
1001000000000000000000001
11111111101100000111000111111111
100000000011000001110111111111111
11110111111111011100000010001
11110111111111011101010010001
11000000110101011100000010001
10000000000000001100000010001
10000000000000001101010010001
110000011101010111110111100111
11110111 1110101 101111010001
11111111 1111111 111111111111





