1111111111111111111111
1000000110000000000001
1P111100000001111110C1
1110000C11110111C01011
1C00111000000001100011
11100000111111000000E1
1111111111111111111111
